**********
*P       *
*        *
*        *
*   M    *
***      *
*        *
*      ***
*   M   G*
**********